C 135,206, 44
F 0,023,0

NO src/textures/aaaa.xpm    
SO src/textures/hem_1.xpm
WE src/textures/cat.xpm
EA src/textures/donkey.xpm



    11111111111111111111111111111111
1111100010000000000110000000000001
111111000001110W000000000011111111
1111111111100100000000000000000001  1111
111111111011000001110000000000001    1011
100000000011000001110111111111111    1111
11110111111111011100000010001
11110111111111011101010010001
11000000110101011100000010001
1000000000000001100000000001
10000000000000001101010010001
110000011101010111100000000111
11110111 11101011101111010001
11111111 1111111 111111111111
