C 135,206 ,235
F 0,0,0

SO src/textures/img1.xpm
NO src/textures/img2.xpm
WE src/textures/img3.xpm
EA src/textures/img4.xpm



    11111111111111111111111111111
11111000W0000000000110000000000001
111111111111000001110000000000001  
1111111111100100000000000000000001  
111111111011000001110000000000001  
100000000011000001110111111111111
11110111111111011100000010001
11110111111111011101010010001
11000000110101011100000010001
1000000000000001100000000001
10000000000000001101010010001
1100000111010101011100000000111
11110111 11101011101111010001
11111111 1111111 111111111111

