SO src/textures/img1.xpm
NO src/textures/img2.xpm
WE src/textures/img3.xpm
EA src/textures/img4.xpm

C 135,206,235
F 34,39,31


1111111111111111111111111111111111111
10000000000000000000000000000000000001
1000000000000000000000000000000000001
1000000000000000000000000000000000001
1000000000000000000000000000000000001
1000000000000000000000000000000000001
1000000000000000000000000000000000001
100000000000000000W000000000000000001
1000000000000000000000000000000000001
1000000000000000000000000000000000001
1000000000000000000000000000000000001
1000000000000000000000000000000000001
1000000000000000000000000000000000001
1000000000000000000000000000000000001
1111111111111111111111111111111111111
